%%%%%%%%%%%%%%%%%%%%
%P   %        %    %
% %% % %%  %%   %% %
%       .   %    % %
% % %% %% %%%    % %
% %    %    % %    %
%.% %% %%%% % %%%%%%
%                 G%
%%%%%%%%%%%%%%%%%%%%
