%%%%%%%%%%%%%%%%%%%
%P                %
%                 %
%                 %
% GGG             %
% oG              %
%%%%%%%%%%%%%%%%%%%
