%%%%%%%%%%%%%%%%%%%%%%%%%%%%
%P                         %
%                          %
%                          %
%                          %
%                          %
%                          %
%                          %
% GGG                      %
% oG                       %
%%%%%%%%%%%%%%%%%%%%%%%%%%%%
