%%%%%%%%%%%%%%%%%%%%%%%%%%%%%%%%%%%%%%%%
%P                                     %
%                                      %
%                                      %
%        Go                            %
%        GGG                           %
%                                      %
%                                      %
%                                      %
%                                      %
%                                      %
%                                      %
%                                      %
%                                      %
%                                      %
%                                      %
%                                      %
%                                      %
%                                      %
%                                      %
%                                      %
%                                      %
%                                      %
%                                      %
%                                      %
%                                      %
%                                      %
%                                      %
%                                      %
%                                      %
%                                      %
%                                      %
%                                      %
%                                      %
%                                      %
%                                      %
%                                      %
%%%%%%%%%%%%%%%%%%%%%%%%%%%%%%%%%%%%%%%%
