%%%%%%%%%%%%%%%%%%%%%%%%%%%%%%%%%%%%%%%%
%P                                     %
%                                      %
%                                      %
%         o                            %
%                                      %
%                                      %
%          G                           %
%      GGG                             %
%                                      %
%                                      %
%                                      %
%                                      %
%                                      %
%                                      %
%                                      %
%                                      %
%                                      %
%                                      %
%                                      %
%                                      %
%                                      %
%                                      %
%                                      %
%                                      %
%                                      %
%                                      %
%                                      %
%                                      %
%                                      %
%                                      %
%                                      %
%                                      %
%                                      %
%                                      %
%                                      %
%                                      %
%%%%%%%%%%%%%%%%%%%%%%%%%%%%%%%%%%%%%%%%
