%%%%%%%%%%%%%%%%%%%%%%%%%%%%%%%%%%%%%%%%%%
%P                                       %
%                                        %
%                                        %
%                                        %
%                                        %
%                                        %
%                                        %
% GGG                                    %
% oG                                     %
%%%%%%%%%%%%%%%%%%%%%%%%%%%%%%%%%%%%%%%%%%
