%%%%%%%%%%%%%%%%%%%%%%%%%%%%%%%%%%%%%%%%
%P                                     %
%                                      %
%                                      %
%         o                            %
%       GGGG                           %
%                                      %
%                                      %
%                                      %
%                                      %
%                                      %
%                                      %
%                                      %
%                                      %
%                                      %
%                                      %
%                                      %
%                                      %
%                                      %
%%%%%%%%%%%%%%%%%%%%%%%%%%%%%%%%%%%%%%%%
