%%%%%%%%%%
%P       %
%        %
%        %
% GGG    %
% oG     %
%%%%%%%%%%
