%%%%%%%%%%%%%%%%%%%%%%%%%%%%%%%%%%%%%%%%
%P                                   G %
%                                      %
%                                      %
%         o                            %
%                                      %
%                                      %
%                                      %
%      GGG                             %
%                                      %
%                                      %
%                                      %
%                                      %
%                                      %
%                                      %
%                                      %
%                                      %
%                                      %
%                                      %
%%%%%%%%%%%%%%%%%%%%%%%%%%%%%%%%%%%%%%%%
