%%%%%%%%%%%%
%          %
%          %
%          %
% GG       %
%PoG       %
%  G       %
%          %
%          %
%          %
%%%%%%%%%%%%
