%%%%%%%%%%%%
%     G   G%
%          %
%          %
%          %
%Po       G%
%          %
%          %
%          %
%         G%
%%%%%%%%%%%%
