%%%%%%%%%%%%%%%%%%%%
%P                 %
%                  %
%                  %
%         o        %
%       GGGG       %
%                  %
%                  %
%                  %
%                  %
%                  %
%                  %
%                  %
%                  %
%   o              %
%                  %
%                  %
%                  %
%                  %
%%%%%%%%%%%%%%%%%%%%
