%%%%%%%%%%%%%%%%%%%%%%%%%%%%%%%%%%%%%%%
%P                                    %
%                                     %
%                                     %
%        Go                           %
%        GGG                          %
%                                     %
%                                     %
%                                     %
%                                     %
%                                     %
%                                     %
%                                     %
%                                     %
%                                     %
%                                     %
%                                     %
%                                     %
%                                     %
%                                     %
%                                     %
%                                     %
%                                     %
%                                     %
%                                     %
%                                     %
%                                     %
%                                     %
%                                     %
%                                     %
%                                     %
%                                     %
%                                     %
%                                     %
%                                     %
%                                     %
%                                     %
%                                     %
%                                     %
%%%%%%%%%%%%%%%%%%%%%%%%%%%%%%%%%%%%%%%
