%%%%%%%%%%%%%%%%%%%%
%P                 %
%                  %
%         G        %
%         o        %
%         G        %
%                  %
%                  %
%                  %
%                  %
%                  %
%                  %
%                  %
%                  %
%  GoG             %
%                  %
%                  %
%                  %
%                  %
%%%%%%%%%%%%%%%%%%%%
