%%%%%%%%%%%%%%%%%%%
%P  G  G      ..G.%
%.% % %%%%%% %.%%.%
%.% % %    % %. %.%
%.%%%.%  %%% %..%.%
%.o ..      G ..% %
%%%%%%%%%%%%%%%%%%%
