%%%%%%%%%%%%%%%%%%%
%P            ....%
%.% % %%%%%% %.%%.%
%.% % %    % %. %.%
%.%%%.%  %%% %..%.%
%.o ..        ..%G%
%%%%%%%%%%%%%%%%%%%
