%%%%%%%%%%%%%%%%%%%
%P            ....%
%.% % %%%%%% %.%%.%
%.%G% %    % %. %.%
%.%%%.%  %%% %..%.%
%.. ..G       ..%G%
%%%%%%%%%%%%%%%%%%%
