%%%%%%%%%%%%%%%%%%%
%P     G   G  ..G.%
%.% % %%%%%% %.%%.%
%.%G% %    % %. %.%
%.%%%.%  %%% %..%.%
%.o ..      G ..%G%
%%%%%%%%%%%%%%%%%%%
