%%%%%%%%%%%%%%%%%%%
%P     G      ....%
%.% % %%%%%% %.%%.%
%.%G% %    % %. %.%
%.%%%.%  %%% %..%.%
%.  ..        ..%G%
%%%%%%%%%%%%%%%%%%%
