%%%%%%%%%%%%%%%%%%%
%             ....%
%.% % %%%%%% %.%%.%
%.% % %    % %. %.%
%.%%%.%  %%% %..%.%
%.. ..       P..%G%
%%%%%%%%%%%%%%%%%%%%
