%%%%%%%%%%%%%%%%%%%
%P            ....%
%.% % %%%%%% %.%%.%
%.%G% %    % %. %.%
%.%%%.%  %%% %..%.%
%.o ..G       ..%G%
%%%%%%%%%%%%%%%%%%%
