%%%%%%%%%%%%%%%%%%%
%P            ....%
%.% % %%%%%% %.%%.%
%.% % %    % %. %.%
%.%%%.%  %%% %..%.%
%.. ..        ..%G%
%%%%%%%%%%%%%%%%%%%%
