%%%%%%%%%%%%%%%%%%%%%%%%%%%%%%%%%%%%%%%%
%P                                     %
%     %%%%          %%%                %
%     %        %           %%%%%%      %
%     %    %   %    Go                 %
%     %    %   %    GGG    %%%%%%      %
%          %%%%%           %    %      %
%     %                    %    %      %
%     %           %     %  %    %      %
%     %%%%        %     %              %
%        %        %     %   %          %
%        %        %     %%%%%%%%%%%    %
%        %        % %   %       %      %
%     %  %        %     %%%     %      %
%     %           %     %       %      %
%     %        %%%%     %  %    %      %
%     %%%%     %        %  %    %      %
%        %     %        %%%%           %
%     %%%%              %              %
%     %  %        %     %              %
%     %  %        %     %%%%%%%%%%%    %
%        %        %%%                  %
%     %%%%     %%%%       %%%%%%%%     %
%              %          %            %
%    %         %%%%%      %            %
%    %                    %            %
%    %              %     %    %       %
%    %          %   %     %    %       %
%    %          %   %     %    %%%     %
%    %          %%%%%     %            %
%    %%%%%        %                    %
%        %        %                    %
%    %   %        %         %%%%%%%%%%%%
%    %   %        %         %  %       %
%    %   %        %         %  %       %
%    %   %        %    %    %  %       %
%    %            %    %               %
%    %         %%%%%%%%%               %
%    %                                 %
%%%%%%%%%%%%%%%%%%%%%%%%%%%%%%%%%%%%%%%%
