%%%%%%%%%%%%%%%%%%%%
%P                 %
%    %%%%%%    %   %
%  %%          %%  %
%  %     Go    %   %
%  %     GGG   %   %
%              %   %
%  %           %   %
%  %        %  %   %
%  %%%%     %      %
%  %  %     %   %  %
%     %     %%%%%  %
%     %%%   %      %
%  %  %     %%%    %
%  %        %      %
%  %        %  %   %
%  %%%%     %  %   %
%     %     %%%%   %
%                  %
%%%%%%%%%%%%%%%%%%%%
