%%%%%%%%%%%%%%%%%%%%%%%%%%%%%%%%%%%%%%%%
%P                                     %
%       %%          %%%    %           %
%     %%       %          %%%%%%%%     %
%     %    %   %    Go    %            %
%     %    %   %    GGG     %%%%%      %
%          %%%%%           %    %      %
%     %        %           %    %      %
%     %           %     %  %    %      %
%     %%%%        %     %              %
%     %  %        %     %   %          %
%        %        %     %%%%%%%%%%%    %
%        %        % %   %       %      %
%     %  %        %     %%%     %      %
%     %           %     %       %      %
%     %        %%%%     %  %    %      %
%     %%%%     %        %  %    %      %
%        %     %        %%%%           %
%                                      %
%%%%%%%%%%%%%%%%%%%%%%%%%%%%%%%%%%%%%%%%
