%%%%%%%%%%
%P       %
%  %%% % %
%   %    %
% GGG  % %
% oG     %
%%%%%%%%%%
