%%%%%%%%%%%%%%%%%%%%
%P                 %
%    %%%%%%    %   %
%  %%          %%  %
%  %      o    %   %
%  %    GGGG   %   %
%              %   %
%  %           %   %
%  %        %  %   %
%  %%%%     %      %
%  %  %     %   %  %
%     %     %%%%%  %
%     %%%   %      %
%  %  %     %%%    %
%  %        %      %
%  %        %  %   %
%  %%%%     %  %   %
%     %     %%%%   %
%                  %
%%%%%%%%%%%%%%%%%%%%
