%%%%%%%%%%%%%%%%%%%
%P                %  
%    %%%%%%    %  %  
%  %%          %% %   
%  %     Go    %  %   
%  %     GGG   %  %   
%              %  %   
%  %           %  %   
%  %        %  %  %   
%  %%%%     %     %   
%  %  %     %   % %  
%     %     %%%%% %  
%     %%%   %     %  
%  %  %     %%%   %  
%  %        %     %  
%  %        %  %  %  
%  %%%%     %  %  %  
%     %     %%%%  %   
%                 % 
%%%%%%%%%%%%%%%%%%% 