%%%%%%%%%%%%%%%%%%%
%                 %
%                 %
%                 %
%                 %
%                 %
%                 %
%                 %
%                 %
%                 %
%                 %
%                 %
%                 %
%                 %
%                 %
%                 %
%                 %
%                 %
%                 %
%                 %
%                 %
%P                %
%%%%%%%%%%%%%%%%%%%