%%%%%%%%%%%%%%%%%%%
%P                %
%    %%%%%%    %  %
%                 %
%         o       %
%       GGGG      %
%                 %
%  %           %  %
%  %        %  %  %
%           %     %
%     %     %     %
%     %     %%%   %
%                 %
%     %      %%   %
%     %           %
%           %     %
%  %%       %     %
%           %     %
%                 %
%%%%%%%%%%%%%%%%%%%
