%%%%%%%%%%%%%%%%%%%
%P                %
%     %%%%%    %  %
%  %           %% %
%  %     Go    %  %
%  %     GGG   %  %
%                 %
%  %              %
%  %              %
%  %%%%     %     %
%     %     %     %
%     %     %     %
%           %     %
%           %     %
%  %        %     %
%  %        %     %
%  %%%%     %     %
%     %     %     %
%                 %
%%%%%%%%%%%%%%%%%%%
