%%%%%%%%%%%%%%%%%%%%%%%%%%%%%%%%%%%%%%%%
%P                                     %
%     %%%%          %%%                %
%     %        %           %%%%%%      %
%     %        %    Go                 %
%     %        %    GGG    %%%%%%      %
%              %           %    %      %
%     %                    %    %      %
%     %           %        %    %      %
%     %%%%        %                    %
%        %        %                    %
%        %        %         %%%%%      %
%        %        %             %      %
%                 %             %      %
%                 %             %      %
%              %%%%             %      %
%     %%%%                      %      %
%        %                             %
%        %                             %
%        %                             %
%        %                %%%%%%%%%    %
%        %                             %
%     %%%%                %%%%%%%%     %
%                         %            %
%    %          %%%%      %            %
%    %                    %            %
%    %                    %    %       %
%    %                    %    %       %
%    %                    %    %%%     %
%    %          %%%%%     %            %
%    %%%%%        %                    %
%                 %                    %
%                 %            %%%%%%%%%
%    %            %            %       %
%    %            %            %       %
%    %            %    %       %       %
%    %            %    %               %
%    %            %%%%%%               %
%    %                                 %
%%%%%%%%%%%%%%%%%%%%%%%%%%%%%%%%%%%%%%%%