%%%%%%%%%%%%%%%%%%%%
%P                 %
%    %%%%%%    %   %
%                  %
%         o        %
%       GGGG       %
%                  %
%  %           %   %
%  %        %  %   %
%           %      %
%     %     %      %
%     %     %%%    %
%                  %
%     %      %%    %
%     %            %
%           %      %
%  %%       %      %
%           %      %
%                  %
%%%%%%%%%%%%%%%%%%%%
