%%%%%%%%%%
%P       %
%  %%%   %
%        %
% GGG    %
% oG     %
%%%%%%%%%%
