%%%%%%%%%%%%%%%%%%%%%%%%%%%%%%%%%%%%%%%
%P                                    %
%               %%%%%%    %           %
%      %                              %
%      %%%%          o                %
%         %        GGGG               %
%         %                           %
%  %      %               %           %
%  %                   %  %           %
%                      %              %
%                %     %              %
%      %         %     %%%            %
%      %                              %
%      %%%%      %      %%            %
%        %       %                    %
%        %             %              %
%  %%                  %              %
%                      %%%%%%%%       %
%                                     %
%%%%%%%%%%%%%%%%%%%%%%%%%%%%%%%%%%%%%%%