%%%%%%%%%%%%%%%%%%%%%%%%%%%%%%%%%%%%%%%
%P                                    %
%               %%%%%%    %           %
%      %                              %
%      %%%%          o                %
%         %        GGGG               %
%         %                           %
%  %      %               %           %
%  %                   %  %           %
%                      %              %
%                      %              %
%      %               %%%%%%%%%%     %
%      %                              %
%      %%%%             %%            %
%        %                            %
%        %                            %
%  %%%%%%%                            %
%                %     %%%%%%%%       %
%                %     %              %
%                %     %              %
%  %%            %     %              %
%                %     %%%%%%%%       %
%                %                    %
%                                     %
%            %                        %
%            %                        %
%                       %%%%%%%%%%%   %
%    %%      %               %        %
%    %       %               %        %
%    %       %                        %
%    %                       %        %
%                            %        %
%                            %        %
%       %                             %
%    %%%%     %%%%%%%%%%              %
%       %                             %
%       %                             %
%       %                             %
%                                     %
%%%%%%%%%%%%%%%%%%%%%%%%%%%%%%%%%%%%%%%