%%%%%%%%%%%%
%oG      G %
%        o %
% o        %
% G        %
%P         %
%          %
%          %
%          %
%     oG   %
%%%%%%%%%%%%
