%%%%%%%%%%%%%%%%%%%%%%%%%%%%%%%%%%%%%%%
%P                                    %
%                                     %
%                                     %
%        Go                           %
%                                     %
%                                     %
%                                     %
%                                     %
%                                     %
%                                     %
%                                     %
%                                     %
%                                     %
%                                     %
%                                     %
%                                     %
%                                     %
%                            oG       %
%                                     %
%                                     %
%                                     %
%                                     %
%                                     %
%                                     %
%     Go                              %
%                                     %
%                                     %
%                                     %
%                                     %
%                                     %
%                                     %
%                                     %
%                                     %
%                                     %
%                                     %
%                        Go           %
%                                     %
%                                     %
%%%%%%%%%%%%%%%%%%%%%%%%%%%%%%%%%%%%%%%
