%%%%%%%%%%%%%%%%%%%%
%P                 %
%                  %
%                  %
%       GoG        %
%                  %
%                  %
%                  %
%                  %
%                  %
%                  %
%                  %
%                  %
%                  %
%                  %
%      GoG         %
%                  %
%                  %
%                  %
%%%%%%%%%%%%%%%%%%%%
