%%%%%%%%%%%%%%%%%%%%
%P                 %
%                  %
%           o      %
%                  %
%                  %
%                  %
%                  %
% G                %
% oG          GoG  %
%                  %
%                  %
%                  %
%                  %
%                  %
%                  %
%    o             %
%                  %
%                  %
%%%%%%%%%%%%%%%%%%%%
