%%%%%%%%%%%%%%%%%%%%
%P                 %
%                  %
%                  %
%       GoG        %
%                  %
%                  %
%                  %
%                  %
%             oG   %
%                  %
%                  %
%                  %
%                  %
%                  %
%      Go          %
%                  %
%                  %
%                  %
%%%%%%%%%%%%%%%%%%%%
