%%%%%%%%%%%%%%%%%%%
%P      oG        %
%     %%%%%    %  %
%  %           %% %
%  %           %  %
%  %           %  %
%                 %
%  %           Go %
%  %              %
%  %%%%     %     %
%  Go %     %     %
%     %     %     %
%           %     %
%           %     %
%  %        %     %
%  %        %     %
%  %%%%  Go %     %
%     %     %     %
%                 %
%%%%%%%%%%%%%%%%%%%
