%%%%%%%%%%
%PoG   Go%
%  %%% % %
%   % Go %
%      % %
% oG     %
%%%%%%%%%%
