%%%%%%%%%%%%%%%%%%%%
%P                 %
%                  %
%         G        %
%         o        %
%                  %
%                  %
%                  %
%           Go     %
%                  %
%                  %
%                  %
%                  %
%                  %
%  Go              %
%                  %
%                  %
%                  %
%             oG   %
%%%%%%%%%%%%%%%%%%%%
