%%%%%%%%%%%%%%%%%%%
%P              Go%  
%    %%%%%%    %  %  
%  %%          %% %   
%  %     Go    %  %   
%  %           %  %   
%              %  %   
%  %           %  %   
%  %        %  %  %   
%  %%%%     %     %   
%  %  %     %   % %  
%oG   %     %%%%% %  
%     %%%   %     %  
%  %  %     %%%   %  
%  %        %     %  
%  %        %  %  %  
%  %%%%     %  %  %  
%     %     %%%%  %   
%        Go       % 
%%%%%%%%%%%%%%%%%%% 