%%%%%%%%%%
%P    Go %
%oG%%%   %
%        %
%     Go %
% oG     %
%%%%%%%%%%
