%%%%%%%%%%%%%%%%%%%
%   %             %
%   %             %
%%%               %
%                 %
%                 %
% % % % % % % % % %
% % % % % % % % % %
% % % % % % % % % %
% % % % % % % % % %
% % % % % % % % % %
% % % % % % % % % %
% % % % % % % % % %
% % % % % % % % % %
% % % % % % % % % %
% % % % % % % % % %
% % % % % % % % % %
%                 %
%                 %
%               %%%
%             %   %
%P            % GG%
%%%%%%%%%%%%%%%%%%%
