%%%%%%%%%%%%%%%%%%%%%%%%%%%%%%%%%%%%%%%%
%P                                   Go%
%     %%%%          %%%                %
%     %        %           %%%%%%      %
%     %    %   %                       %
%     %    %   %           %%%%%%      %
%          %%%%%           %    %      %
%     %                    %    %      %
%     %           %     %  %    %      %
%     %%%%        %     %              %
%        %        %     %   %          %
%        %Go      %     %%%%%%%%%%%    %
%        %        % %   %       %      %
%     %  %        %     %%%     %      %
%     %           %     %       %      %
%     %        %%%%     %  %    %      %
%     %%%%     %        %  %    %      %
%        %     %        %%%%           %
%     %%%%              %        oG    %
%     %  %        %     %              %
%     %  %        %     %%%%%%%%%%%    %
%        %        %%%                  %
%     %%%%     %%%%       %%%%%%%%     %
%              %          %            %
%    %         %%%%%      %            %
%    %                    %            %
%    %              %     %    %       %
%    %          %   %     %    %       %
%    %          %   %     %    %%%     %
%oG  %          %%%%%     %            %
%    %%%%%        %                    %
%        %        %                    %
%    %   %        %         %%%%%%%%%%%%
%    %   %        %         %  %       %
%    %   %        %         %  %       %
%    %   %        %    %    %  %       %
%    %            %    %               %
%    %         %%%%%%%%%               %
%    %                                 %
%%%%%%%%%%%%%%%%%%%%%%%%%%%%%%%%%%%%%%%%
