%%%%%%%%%%%%%%%%%%%%
%P                 %
%                  %
%         Go       %
%                  %
%                  %
%                  %
%                  %
%                  %
% oG          oG   %
%                  %
%                  %
%                  %
%                  %
%                  %
%               o  %
%    oG            %
%                  %
%                  %
%%%%%%%%%%%%%%%%%%%%
