%%%%%%%%%%%%%%%%%%%%
%P                 %
%                  %
%           o      %
%                  %
%                  %
%                  %
%                  %
% G                %
% o           GoG  %
%                  %
%                  %
%                  %
%                  %
%                  %
%                  %
%    oG            %
%                  %
%                  %
%%%%%%%%%%%%%%%%%%%%
