%%%%%%%%%%%%%%%%%%%%
%                  %
%                  %
%                  %
%                  %
%...... GGGG%.%....%
%                  %
%                  %
%                  %
%                  %
%                  %
%                  %
%                  %
%                  %
%                  %
%                  %
%                  %
%                  %
%                  %
%%%%%%%%%%%%%%%%%%%%
