%%%%%%%%%%%%%%%%%%%
%...%           G %
%   %             %
%%%      o        %
%                 %
%                 %
% % % % % % % % % %
% % % % % % % % % %
% % % % % % % % % %
% % % % % % % % % %
% % % % % % % % % %
% % % % % % % % % %
% % % % %G% % % % %
% % % % % % % % % %
% % % % % % % % % %
% % % % % % % % % %
% % % % % % % % % %
%                 %
%                 %
%   G             %
%              G  %
%P                %
%%%%%%%%%%%%%%%%%%%
