%%%%%%%%%%%%%%%%%%%%
%P                 %
%                  %
%          o       %
%                  %
%                  %
%                  %
%                  %
%              G   %
% o           GoG  %
%              G   %
%                  %
%                  %
%                  %
%                  %
%                  %
%    o             %
%                  %
%                  %
%%%%%%%%%%%%%%%%%%%%
