%%%%%%%%%%%%%%%%%%%%
%P                 %
%                  %
%         G        %
%       GoG        %
%         G        %
%                  %
%                  %
%                  %
%                  %
%                  %
%                  %
%                  %
%                  %
%                  %
%                  %
%                  %
%                  %
%                  %
%%%%%%%%%%%%%%%%%%%%
