%%%%%%%%%%%%%%%%%
%G %         % G%
%%  %       %  %%
% %  %     %  % %
%  %  %   %  %  %
%   %  % %  %   %
%    %  %  %    %
%     %   %     %
%      % %      %
%      % %      %
%      % %      %
%      % %      %
%               %
%               %
%               %
%               %
%               %
%               %
%               %
%               %
%               %
%P              %
%%%%%%%%%%%%%%%%%