%%%%%%%%%%%%%%%%%%%
%  P          ....%
%.% % %%%%%% %.%%.%
%.%o% %   o% %.o%.%
%.%%%.%  %%% %..%.%
%..P..       P..%G%
%%%%%%%%%%%%%%%%%%%%
