%%%%%%%%%%%%%%%%%%%
%  P          ....%
%.% % %%%%%% %.%%.%
%.%o% %   o% %.o%.%
%.%%%.%  %%% %..%.%
%..          P..%G%
%%%%%%%%%%%%%%%%%%%%
